wwwwwwwwwwwwwwwwwwwwwwwwwwwwwww
w.............................w
w......................ws..o..w
w.............sww..w..w.s..w..w
w.............s.........s.k..mw
w.............s........wwwwww.w
w.....m.......s...............w
w...swwwwwwwwww...............w
w...s.........................w
w...s.........................w
wk..s..m..............m......kw
wwwwwwwwwwww..ww..wwwwwwwswwwww
w........................s....w
w........................s....w
w..i.....................s....w
wwwwwwwwwwwwwwwwwwwwwwwwwwwwwww
