wwwwwwwwwwwwwwwwwwwwwwwwwwwwwww
w.............................w
w.......................m..k..w
w.......................swwws.w
w.......................s...s.w
w.......................s...s.w
w.......................s...s.w
w.........m...........m.s...s.w
w.swww..www..ww..wwwwwwww...s.w
w.s.........................s.w
w.s.........................s.w
w.s.m......m....m.............w
w.wwww..w..www..wwww..wwws....w
w........................s....w
wo.......................s..i.w
wwwwwwwwwwwwwwwwwwwwwwwwwwwwwww
