wwwwwwwwwwwwwwwwwwwwwwwwwwwwwww
w...............w.............w
wk.m..m.k.......w..k.........kw
ws.w.wwwwwwwwswwwwwww..wwsw..ww
ws...........s...........s....w
www..........s...........s....w
w............s...........s....w
w.ww.........s...........sm..kw
w............ww..swwww..wwww.ww
w................s............w
www..............s............w
w................s............w
w..ww............s............w
w................s............w
w.......o........s.....i..k...w
wwwwwwwwwwwwwwwwwwwwwwwwwwwwwww
